ad : da
ados : soda
agar : raga
agas : saga
agenes : senega
aider : redia
airts : stria
ajar : raja
alif : fila
am : ma
amen : nema
amis : sima
anger : regna
animal : lamina
animes : semina
ante : etna
ares : sera
arris : sirra
at : ta
ates : seta
auks : skua
avo : ova
bag : gab
bals : slab
ban : nab
bat : tab
bats : stab
bed : deb
ben : neb
bid : dib
big : gib
bin : nib
bins : snib
bird : drib
bis : sib
bog : gob
bos : sob
bots : stob
bows : swob
brad : darb
bud : dub
bun : nub
bur : rub
burd : drub
burg : grub
bus : sub
but : tub
buts : stub
cap : pac
cram : marc
dag : gad
dah : had
dahs : shad
dam : mad
dap : pad
dart : trad
daw : wad
debut : tubed
decal : laced
deem : meed
deer : reed
defer : refed
degami : imaged
deifier : reified
deil : lied
deke : eked
delf : fled
deliver : reviled
demit : timed
denier : reined
denim : mined
dens : sned
derats : stared
devil : lived
dewans : snawed
dialer : relaid
dig : gid
dim : mid
dinar : ranid
diols : sloid
dirts : strid
do : od
dog : god
door : rood
draw : ward
drawer : reward
draws : sward
ducs : scud
duo : oud
edile : elide
edit : tide
eel : lee
elides : sedile
em : me
emes : seme
emit : time
er : re
ergo : ogre
eros : sore
ervil : livre
etas : sate
even : neve
evil : live
fer : ref
fires : serif
flog : golf
flow : wolf
fool : loof
gals : slag
gam : mag
gan : nag
gar : rag
gat : tag
gats : stag
gelder : redleg
get : teg
gip : pig
girt : trig
gnar : rang
gnaws : swang
gul : lug
guls : slug
gums : smug
guns : snug
habus : subah
hahs : shah
hales : selah
hap : pah
hay : yah
ho : oh
hoop : pooh
hop : poh
is : si
it : ti
kay : yak
keel : leek
keels : sleek
knaps : spank
knar : rank
lares : seral
larum : mural
las : sal
leets : steel
leper : repel
lever : revel
levins : snivel
liar : rail
lin : nil
loom : mool
looter : retool
lop : pol
lotos : sotol
macs : scam
maes : seam
map : pam
marcs : scram
maws : swam
may : yam
meet : teem
mho : ohm
mir : rim
mon : nom
moor : room
moot : toom
mures : serum
mus : sum
muts : stum
namer : reman
nap : pan
naps : span
neves : seven
new : wen
nips : spin
notes : seton
now : won
nu : un
nut : tun
oot : too
os : so
ow : wo
par : rap
part : trap
pas : sap
paws : swap
peels : sleep
pees : seep
per : rep
pis : sip
pools : sloop
poons : snoop
ports : strop
pot : top
pots : stop
prat : tarp
pupils : slipup
puris : sirup
pus : sup
put : tup
raps : spar
rats : star
raw : war
ray : yar
rebus : suber
redes : seder
redips : spider
rees : seer
reflet : telfer
reknits : stinker
relit : tiler
remeet : teemer
remit : timer
rennet : tenner
repins : sniper
res : ser
rot : tor
saps : spas
saw : was
scares : seracs
secret : terces
seeks : skees
sirs : sris
sit : tis
sleeps : speels
sleets : steels
slit : tils
sloops : spools
smart : trams
smuts : stums
snaps : spans
snaw : wans
snaws : swans
snips : spins
snit : tins
snoops : spoons
snot : tons
snow : wons
sow : wos
spat : taps
spay : yaps
spirt : trips
spirts : strips
spit : tips
sports : strops
spot : tops
sprat : tarps
sprits : stirps
staw : wats
stew : wets
stow : wots
stows : swots
straw : warts
struts : sturts
swat : taws
sway : yaws
swot : tows
tav : vat
tort : trot
